10
5
+---+---+---+---+   +   +---+---+---+---+
  R | P | P | R   R | R   R   R | P | B |
+   +---+---+---+   +   +---+   +---+---+
| R | P | B | P | R | R | P | R | P | P |
+   +---+---+---+   +   +---+---+---+---+
| R   R   R | X | R   R | X | P | P | P |
+---+---+   +---+   +---+---+---+---+---+
| P | P | R   R   R   R   R   R   R | P |
+---+---+---+---+---+   +---+   +---+---+
| B | P | P | B | P | R | B | R | P | B |
+---+---+---+---+---+   +---+   +---+---+