20
20
+---+---+---+---+---+   +---+---+---+---+   +---+---+---+---+   +---+---+---+---+
| O | F | F | F | F | R | F | F | F | F | R | F | F | F | F | R | F | F | F | F |
+---+---+---+---+---+   +---+---+---+---+   +---+---+---+---+   +---+---+---+---+
  R   R   R   R   R   R   R   R   R   R   R   R   R   R   R   R   R   R   R   R  
+---+---+---+---+---+   +---+---+---+---+   +---+---+---+---+   +---+---+---+---+
| O | F | F | F | F | R | S | F | F | F | R | F | F | F | S | R | F | F | F | F |
+---+---+---+---+---+   +---+---+---+---+   +---+---+---+---+   +---+---+---+---+
  R   R   R   R   R   R   R   R   R   R   R   R   R   R   R   R   R   R   R   R  
+---+---+---+---+---+   +---+---+---+---+   +---+---+---+---+   +---+---+---+---+
| O | F | F | F | F | R | F | F | F | F | R | F | F | F | F | R | F | F | F | F |
+---+---+---+---+---+   +---+---+---+---+   +---+---+---+---+   +---+---+---+---+
  R   R   R   R   R   R   R   R   R   R   R   R   R   R   R   R   R   R   R   R  
+---+---+---+---+---+   +---+---+---+---+   +---+---+---+---+   +---+---+---+---+
| O | F | F | F | F | R | S | F | F | F | R | F | F | F | S | R | F | F | F | F |
+---+---+---+---+---+   +---+---+---+---+   +---+---+---+---+   +---+---+---+---+
  R   R   R   R   R   R   R   R   R   R   R   R   R   R   R   R   R   R   R   R  
+---+---+---+---+---+   +---+---+---+---+   +---+---+---+---+   +---+---+---+---+
| O | F | F | F | F | R | F | F | F | F | R | F | F | F | F | R | F | F | F | F |
+---+---+---+---+---+   +---+---+---+---+   +---+---+---+---+   +---+---+---+---+
  R   R   R   R   R   R   R   R   R   R   R   R   R   R   R   R   R   R   R   R  
+---+---+---+---+---+   +---+---+---+---+   +---+---+---+---+   +---+---+---+---+
| O | F | F | F | F | R | S | F | F | F | R | F | F | F | S | R | F | F | F | F |
+---+---+---+---+---+   +---+---+---+---+   +---+---+---+---+   +---+---+---+---+
  R   R   R   R   R   R   R   R   R   R   R   R   R   R   R   R   R   R   R   R  
+---+---+---+---+---+   +---+---+---+---+   +---+---+---+---+   +---+---+---+---+
| O | F | F | F | F | R | F | F | F | F | R | F | F | F | F | R | F | F | F | F |
+---+---+---+---+---+   +---+---+---+---+   +---+---+---+---+   +---+---+---+---+
  R   R   R   R   R   R   R   R   R   R   R   R   R   R   R   R   R   R   R   R  
+---+---+---+---+---+   +---+---+---+---+   +---+---+---+---+   +---+---+---+---+
| O | F | F | F | F | R | S | F | F | F | R | F | F | F | S | R | F | F | F | F |
+---+---+---+---+---+   +---+---+---+---+   +---+---+---+---+   +---+---+---+---+
  R   R   R   R   R   R   R   R   R   R   R   R   R   R   R   R   R   R   R   R  
+---+---+---+---+---+   +---+---+---+---+   +---+---+---+---+   +---+---+---+---+
| O | F | F | F | F | R | F | F | F | F | R | F | F | F | F | R | F | F | F | F |
+---+---+---+---+---+   +---+---+---+---+   +---+---+---+---+   +---+---+---+---+
  R   R   R   R   R   R   R   R   R   R   R   R   R   R   R   R   R   R   R   R  
+---+---+---+---+---+   +---+---+---+---+   +---+---+---+---+   +---+---+---+---+
| O | F | F | F | F | R | S | F | F | F | R | F | F | F | S | R | F | F | F | F |
+---+---+---+---+---+   +---+---+---+---+   +---+---+---+---+   +---+---+---+---+
  R   R   R   R   R   R   R   R   R   R   R   R   R   R   R   R   R   R   R   R  
+---+---+---+---+---+   +---+---+---+---+   +---+---+---+---+   +---+---+---+---+