10
5
+---+---+---+---+   +   +---+---+---+---+
  R | F | O | R   R | R   R   R | F | F |
+   +---+---+---+   +   +---+   +---+---+
| R | F | F | F | R | R | O | R | O | F |
+   +---+---+---+   +   +---+---+---+---+
| R   R   R | O | R   R | O | F | F | O |
+---+---+   +---+   +---+---+---+---+---+
| O | F | R   R   R   R   R   R   R | O |
+---+---+---+---+---+   +---+   +---+---+
| F | F | F | F | F | R | O | R   R   R |
+---+---+---+---+---+   +---+   +---+---+
