10
5
+---+---+---+---+   +   +---+---+---+---+
  R | F | X | R   R | R   R   R | F | F |
+   +---+---+---+   +   +---+   +---+---+
| R | F | F | F | R | R | X | R | X | F |
+   +---+---+---+   +   +---+---+---+---+
| R   R   R | X | R   R | X | F | F | X |
+---+---+   +---+   +---+---+---+---+---+
| X | F | R   R   R   R   R   R   R | X |
+---+---+---+---+---+   +---+   +---+---+
| F | F | F | F | F | R | X | R | F | F |
+---+---+---+---+---+   +---+   +---+---+
