10
6
+---+---+---+---+---+---+---+---+---+---+
| B| R   R   R | F | B| F | F | F | B|
+---+   +---+   +---+---+---+---+---+---+
| B| R | F | R | F | B| R   R   R | B|
+---+   +---+   +---+---+   +---+   +---+
| B| R   R   R   R   R   R | F | R   R |
+---+---+   +   +---+---+   +---+---+   +
| B| R   R   R   R   R   R | F | R   R |
+---+   +---+   +---+---+   +---+   +---+
| B| R | F | R | F | B| R   R   R | B|
+---+   +---+   +---+---+---+---+---+---+
| B| R   R   R | F | B| F | F | F | B|
+---+---+---+---+---+---+---+---+---+---+
