10
5
+---+---+---+---+   +   +---+---+---+---+
  R | F | F | R   R | R   R   R | F | F |
+   +---+---+---+   +   +---+   +---+---+
| R | F | F | F | R | R | F | R | F | F |
+   +---+---+---+   +   +---+---+---+---+
| R   R   R | X | R   R | X | F | F | F |
+---+---+   +---+   +---+---+---+---+---+
| F | F | R   R   R   R   R   R   R | F |
+---+---+---+---+---+   +---+   +---+---+
| F | F | F | F | F | R | F | R | F | F |
+---+---+---+---+---+   +---+   +---+---+
