10
5
+---+---+---+---+   +   +---+---+---+---+
  R | F | F | R   R | R   R   R | F | B|
+   +---+---+---+   +   +---+   +---+---+
| R | F | B| F | R | R | F | R | F | F |
+   +---+---+---+   +   +---+---+---+---+
| R   R   R | X | R   R | X | F | F | F |
+---+---+   +---+   +---+---+---+---+---+
| F | F | R   R   R   R   R   R   R | F |
+---+---+---+---+---+   +---+   +---+---+
| B| F | F | B| F | R | B| R | F | B|
+---+---+---+---+---+   +---+   +---+---+
