-----------------------------------------
| B | P | P | B | X | P | B | P | P | B |
-----------------------------------------
| P | P | b | P | P | P | P | b | P | P |
-----------------------------------------
| P | P |   | X | P | P | X | P | P | P |
-----------------------------------------
| P | P | b | P | P | P | P | b | P | P |
-----------------------------------------
| B | P | P | B | P | X | B | P | P | B |
-----------------------------------------